0000000000000000000000000000000000000000000000000000000000000000000000000000000
0000000000000000000000000000000000000000000000000000000000000000000000000000000
0000000000000000000000000000000000000000000000000000000000000000000000000000000
0000000000000000000000000000000000000000000000000000000000000000000000000000000
0004000000000040000000040000000000000000000000040000400000000000040000000000000
0004000000000040004000040000440000000000000000040000404000400000040000000004004
0004000004000040004000040000440004000000000000040004404400400000040000400004004
0404000004040040004000044000440044000000000000040004404404400040040000400004044
0404400004040040004000044000440444000000000040040004404404400040040004400000000
1111121111112111001122111011211211110111110020011111111111111111221111211111111
0000000111112221201111212222111111220212111011122221111120011101110000000000011
0111222211111111011111111111110000022012200102211111111110211111111111111111000
2212222221111111111111111121101111000200011121111111111111112202121111110010010
0111101121221011111111111111122222201111111111221000111111111111111111100000111
0000012222111000221111120210011111111111111111111111111111000011211111112222220
1110001111111110001111111220111222220021111111112000210021101110022222221110000
1222222210000022221122211111202222211221111111001111022211111110111112222211110
0220112111211111100000000222222221111111112122222222021222111221111122110011112
1111111111221111110111111111100101111111222211001111110011111111112021111111110
2211111111111111122202200210221111111111111111102222111102222200000112111111010
0111111111111102222210221111111011111112211121111111001111111222111211100011110
1111111111111111122211111111222211112221111111221111110022111110000000011110001
